tDate,NewSum,NewInflowChina,NewInflowAsia,NewInflowEU,NewInflowAmerica,NewInflowAfrica,NewInflowOS,NewConfirmQuarantine,NewConfirmSocial,NewNationalityLocal,NewNationalityForeigner,AccSum,AccInflowChina,AccInflowAsia,AccInflowEU,AccInflowAmerica,AccInflowAfrica,AccInflowOS,AccConfirmQuarantine,AccConfirmSocial,AccNationalityLocal,AccNationalityForeigner
2020-09-15,15,0,5,2,8,0,0,5,10,8,7,3029,23,1438,556,916,82,14,1428,1601,1882,1147
2020-09-16,8,0,3,2,2,1,0,2,6,5,3,3038,23,1442,558,918,83,14,1430,1608,1888,1150
2020-09-17,8,0,6,0,2,0,0,2,6,5,3,3046,23,1449,557,920,83,14,1432,1614,1893,1153
2020-09-18,17,0,9,3,5,0,0,2,15,5,12,3063,23,1458,560,925,83,14,1434,1629,1898,1165
2020-09-19,4,0,4,0,0,0,0,1,3,2,2,3067,23,1462,560,925,83,14,1435,1632,1900,1167
2020-09-20,10,0,6,3,1,0,0,6,4,1,9,3077,23,1468,563,926,83,14,1441,1636,1901,1176
2020-09-21,15,0,11,3,0,0,1,10,5,4,11,3092,23,1479,566,926,83,15,1451,1641,1905,1187
2020-09-22,10,0,5,1,4,0,0,2,8,1,9,3102,23,1484,567,930,83,15,1453,1649,1906,1196
2020-09-23,11,0,8,2,1,0,0,6,5,5,6,3114,23,1492,570,931,83,15,1459,1655,1912,1202
2020-09-24,15,0,10,3,2,0,0,5,10,3,12,3129,23,1502,573,933,83,15,1464,1665,1915,1214
2020-09-25,19,0,15,2,2,0,0,6,13,3,16,3149,23,1518,574,936,83,15,1470,1679,1919,1230
2020-09-26,12,0,10,1,1,0,0,9,3,7,5,3161,23,1536,567,937,83,15,1479,1682,1926,1235
2020-09-27,22,0,18,3,1,0,0,11,11,9,13,3183,23,1554,570,938,83,15,1490,1693,1935,1248
2020-09-28,10,0,8,1,1,0,0,7,3,7,3,3193,23,1562,571,939,83,15,1497,1696,1942,1251
2020-09-29,15,0,9,2,4,0,0,9,6,3,12,3208,23,1571,573,943,83,15,1506,1702,1945,1263
2020-09-30,20,0,18,1,1,0,0,5,15,5,15,3228,23,1589,574,944,83,15,1511,1717,1950,1278
2020-10-01,10,0,8,0,1,1,0,6,4,2,8,3237,23,1596,574,945,84,15,1517,1720,1952,1285
2020-10-02,10,0,7,3,0,0,0,6,4,5,5,3247,23,1603,577,945,84,15,1523,1724,1957,1290
2020-10-03,23,0,12,5,3,3,0,14,9,10,13,3270,23,1615,582,948,87,15,1537,1733,1967,1303
2020-10-04,17,0,13,3,1,0,0,9,8,6,11,3287,23,1628,585,949,87,15,1546,1741,1973,1314
2020-10-05,9,0,3,4,2,0,0,2,7,7,2,3296,23,1631,589,951,87,15,1548,1748,1980,1316
2020-10-06,9,0,4,3,1,1,0,5,4,3,6,3305,23,1635,592,952,88,15,1553,1752,1983,1322
2020-10-07,20,1,15,2,0,2,0,7,13,11,9,3325,24,1650,594,952,90,15,1560,1765,1994,1331
2020-10-08,9,0,5,1,3,0,0,3,6,2,7,3334,24,1655,595,955,90,15,1563,1771,1996,1338
2020-10-09,16,0,5,1,8,2,0,6,10,4,12,3350,24,1660,596,963,92,15,1569,1781,2000,1350
2020-10-10,11,0,6,5,0,0,0,5,6,6,5,3361,24,1666,601,963,92,15,1574,1787,2006,1355
2020-10-11,12,0,8,2,2,0,0,3,9,6,6,3373,24,1674,603,965,92,15,1577,1796,2012,1361
2020-10-12,29,0,25,1,2,1,0,9,20,5,24,3402,24,1699,604,967,93,15,1586,1816,2017,1385
2020-10-13,33,0,26,1,6,0,0,21,12,4,29,3435,24,1725,605,973,93,15,1607,1828,2021,1414
2020-10-14,31,0,16,0,15,0,0,14,17,2,29,3466,24,1741,605,988,93,15,1621,1845,2023,1443
2020-10-15,15,0,7,3,4,1,0,6,9,3,12,3470,24,1737,608,992,94,15,1616,1854,2026,1444
2020-10-16,6,0,3,1,2,0,0,3,3,1,5,3476,24,1740,609,994,94,15,1619,1857,2027,1449
2020-10-17,11,0,7,3,1,0,0,5,6,7,4,3487,24,1747,612,995,94,15,1624,1863,2034,1453
2020-10-18,20,0,17,1,2,0,0,13,7,4,16,3507,24,1764,613,997,94,15,1637,1870,2038,1469
2020-10-19,26,0,15,7,3,1,0,12,14,8,18,3533,24,1779,620,1000,95,15,1649,1884,2047,1486
2020-10-20,17,2,3,3,8,1,0,3,14,3,14,3550,26,1782,623,1008,96,15,1652,1898,2050,1500
2020-10-21,34,0,19,11,3,1,0,22,12,9,25,3584,26,1801,634,1011,97,15,1674,1910,2059,1525
2020-10-22,17,0,7,5,3,2,0,9,8,4,13,3599,26,1806,639,1014,99,15,1681,1918,2063,1536
2020-10-23,17,0,8,3,6,0,0,8,9,6,11,3616,26,1814,642,1020,99,15,1689,1927,2069,1547
2020-10-24,11,0,6,1,4,0,0,6,5,4,7,3627,26,1820,643,1024,99,15,1695,1932,2073,1554
2020-10-25,11,0,6,4,0,1,0,9,2,3,8,3638,26,1826,647,1024,100,15,1704,1934,2076,1562
2020-10-26,25,0,17,6,1,1,0,17,8,10,15,3663,26,1843,653,1025,101,15,1721,1942,2086,1577
2020-10-27,16,0,3,6,7,0,0,5,11,6,10,3679,26,1846,659,1032,101,15,1726,1953,2092,1587
2020-10-28,7,0,3,2,0,2,0,2,5,2,5,3686,26,1850,660,1032,103,15,1728,1958,2094,1592
2020-10-29,19,0,10,1,8,0,0,9,10,6,13,3705,26,1860,661,1040,103,15,1737,1968,2100,1605
2020-10-30,21,0,8,4,9,0,0,4,17,11,10,3726,26,1868,665,1049,103,15,1741,1985,2111,1615
2020-10-31,31,0,23,2,6,0,0,25,6,5,26,3755,26,1890,667,1054,103,15,1766,1989,2116,1639
2020-11-01,23,0,19,3,1,0,0,14,9,11,12,3778,26,1909,670,1055,103,15,1780,1998,2127,1651
2020-11-02,18,0,11,4,3,0,0,7,11,6,12,3796,26,1920,674,1058,103,15,1787,2009,2133,1663
2020-11-03,29,0,7,8,13,1,0,12,17,13,16,3825,26,1927,682,1071,104,15,1799,2026,2146,1679
2020-11-04,20,0,7,8,5,0,0,11,9,9,11,3845,26,1934,690,1076,104,15,1810,2035,2155,1690
2020-11-05,17,0,9,5,3,0,0,6,11,5,12,3862,26,1943,695,1079,104,15,1816,2046,2160,1702
2020-11-06,28,0,9,4,12,1,2,11,17,5,23,3890,26,1952,699,1091,105,17,1827,2063,2165,1725
2020-11-07,17,0,4,4,6,3,0,8,9,6,11,3907,26,1956,703,1097,108,17,1835,2072,2171,1736
2020-11-08,25,0,6,9,8,2,0,14,11,17,8,3932,26,1962,712,1105,110,17,1849,2083,2188,1744
2020-11-09,27,0,13,8,5,1,0,11,16,16,11,3959,26,1975,720,1110,111,17,1860,2099,2204,1755
2020-11-10,29,0,5,6,18,0,0,8,21,11,18,3988,26,1980,726,1128,111,17,1868,2120,2215,1773
2020-11-11,33,0,11,6,13,3,0,8,25,18,15,4021,26,1991,732,1141,114,17,1876,2145,2233,1788
2020-11-12,15,0,7,2,1,4,1,9,6,4,11,4036,26,1998,734,1142,118,18,1885,2151,2237,1799
2020-11-13,29,0,11,4,12,2,0,14,15,7,22,4065,26,2009,738,1154,120,18,1899,2166,2244,1821
2020-11-14,39,1,19,8,11,0,0,21,18,19,20,4104,27,2031,746,1165,117,18,1920,2184,2263,1841
2020-11-15,32,0,16,6,10,0,0,18,14,22,10,4136,27,2047,752,1175,117,18,1938,2198,2285,1851
2020-11-16,30,0,24,2,4,0,0,23,7,10,20,4166,27,2071,754,1179,117,18,1961,2205,2295,1871
2020-11-17,28,0,14,2,12,0,0,8,20,8,20,4194,27,2084,756,1191,118,18,1969,2225,2303,1891
2020-11-18,68,0,21,8,38,1,0,50,18,18,50,4262,27,2105,764,1229,119,18,2019,2243,2321,1941
2020-11-19,50,0,23,7,14,6,0,39,11,17,33,4312,27,2128,771,1243,125,18,2058,2254,2338,1974
2020-11-20,43,0,22,4,16,1,0,23,20,12,31,4355,27,2150,775,1259,126,18,2081,2274,2350,2005
2020-11-21,25,0,10,3,12,0,0,9,16,13,12,4380,27,2160,778,1271,126,18,2090,2290,2363,2017
2020-11-22,28,0,16,3,8,1,0,20,8,15,13,4408,27,2176,781,1279,127,18,2110,2298,2378,2030
2020-11-23,16,0,5,5,3,3,0,5,11,10,6,4424,27,2181,786,1282,130,18,2115,2309,2388,2036
2020-11-24,29,0,11,6,11,1,0,10,19,8,21,4453,27,2192,792,1293,131,18,2125,2328,2396,2057
2020-11-25,19,0,6,3,9,1,0,7,12,9,10,4472,27,2198,795,1302,132,18,2132,2340,2405,2067
2020-11-26,30,1,11,6,8,4,0,12,18,14,16,4504,28,2209,801,1311,137,18,2144,2360,2422,2082
2020-11-27,44,0,4,19,20,1,0,31,13,13,31,4548,28,2213,820,1331,138,18,2175,2373,2435,2113
2020-11-28,18,0,8,2,8,0,0,3,15,8,10,4551,28,2221,812,1334,138,18,2164,2387,2443,2108
2020-11-29,37,2,12,9,13,1,0,17,20,27,10,4587,30,2233,821,1346,139,18,2181,2406,2470,2117
2020-11-30,24,0,12,6,6,0,0,10,14,10,14,4550,30,2205,827,1334,136,18,2130,2420,2480,2070
2020-12-01,31,0,6,5,19,1,0,14,17,15,16,4581,30,2211,832,1353,137,18,2144,2437,2495,2086
2020-12-02,18,0,8,4,5,1,0,6,12,11,7,4599,30,2219,836,1358,138,18,2150,2449,2506,2093
2020-12-03,24,0,10,4,9,1,0,13,11,8,16,4623,30,2229,840,1367,139,18,2163,2460,2514,2109
2020-12-04,29,0,18,2,9,0,0,18,11,12,17,4652,30,2247,842,1376,139,18,2181,2471,2526,2126
2020-12-05,24,0,12,3,9,0,0,12,12,8,16,4676,30,2259,846,1384,139,18,2193,2483,2534,2142
2020-12-06,32,0,13,6,12,1,0,12,20,16,16,4708,30,2273,852,1395,140,18,2205,2503,2550,2158
2020-12-07,35,0,14,9,12,0,0,10,25,22,13,4743,30,2286,861,1408,140,18,2215,2528,2572,2171
2020-12-08,28,0,7,1,17,2,1,7,21,12,16,4772,30,2294,862,1425,142,19,2222,2550,2584,2188
2020-12-09,24,0,5,8,11,0,0,9,15,20,4,4789,30,2292,870,1437,142,18,2231,2558,2606,2183
2020-12-10,36,0,10,7,19,0,0,16,20,22,14,4825,30,2301,878,1456,142,18,2240,2585,2627,2198
2020-12-11,16,0,5,3,4,4,0,7,9,5,11,4842,30,2307,881,1460,146,18,2247,2595,2632,2210
2020-12-12,22,0,8,5,7,2,0,12,10,13,9,4864,30,2315,886,1467,148,18,2259,2605,2645,2219
2020-12-13,28,1,13,5,6,3,0,14,14,17,11,4892,31,2328,891,1473,151,18,2273,2619,2662,2230
2020-12-14,36,0,21,2,8,5,0,17,19,22,14,4930,31,2349,893,1481,157,19,2290,2640,2685,2245
2020-12-15,32,1,4,6,19,2,0,8,24,11,21,4962,32,2353,899,1500,159,19,2298,2664,2696,2266
2020-12-16,24,0,11,2,10,1,0,6,18,13,11,4986,32,2364,901,1510,160,19,2304,2682,2710,2276
2020-12-17,21,0,7,5,7,2,0,7,14,11,10,5006,32,2370,906,1517,162,19,2311,2695,2720,2286
2020-12-18,26,0,9,2,13,1,1,9,17,17,9,5032,32,2379,908,1530,163,20,2320,2712,2737,2295
2020-12-19,24,2,5,2,14,1,0,4,20,13,11,5057,34,2385,910,1544,164,20,2324,2733,2751,2306
2020-12-20,25,0,9,6,10,0,0,9,16,18,7,5082,34,2394,916,1554,164,20,2333,2749,2769,2313
2020-12-21,34,0,13,8,13,0,0,10,24,21,13,5116,34,2407,924,1567,164,20,2343,2773,2790,2326
2020-12-22,45,0,20,4,19,2,0,18,27,24,21,5161,34,2427,928,1586,166,20,2361,2800,2814,2347
2020-12-23,32,0,17,8,6,0,1,9,23,21,11,5193,34,2444,936,1592,166,21,2370,2823,2835,2358
2020-12-24,30,1,11,3,15,0,0,11,19,16,14,5223,35,2455,939,1607,166,21,2381,2842,2851,2372
2020-12-25,25,0,12,2,9,2,0,6,19,15,10,5245,33,2467,941,1615,168,21,2387,2858,2864,2381
2020-12-26,28,0,12,4,11,1,0,10,18,19,9,5273,33,2479,945,1626,169,21,2397,2876,2883,2390
2020-12-27,24,0,18,1,4,1,0,10,14,15,9,5297,33,2497,946,1630,170,21,2407,2890,2898,2399
2020-12-28,21,0,10,5,5,1,0,8,13,12,9,5318,33,2507,951,1635,171,21,2415,2903,2910,2408
2020-12-29,16,0,10,3,3,0,0,5,11,6,10,5334,33,2517,954,1638,171,21,2420,2914,2916,2418
2020-12-30,25,0,12,3,10,0,0,11,14,15,10,5358,33,2528,957,1648,171,21,2431,2927,2931,2427
2020-12-31,27,0,13,7,7,0,0,13,14,14,13,5385,33,2541,964,1655,171,21,2444,2941,2945,2440
2021-01-01,25,1,6,5,10,2,1,4,21,13,12,5410,34,2547,969,1665,173,22,2448,2962,2958,2452
2021-01-02,36,0,17,4,14,1,0,14,22,21,15,5446,34,2564,973,1679,174,22,2462,2984,2979,2467
2021-01-03,16,0,5,4,7,0,0,8,8,14,2,5462,34,2569,977,1686,174,22,2470,2992,2993,2469
2021-01-04,35,0,14,2,18,1,0,11,24,22,13,5497,34,2583,979,1704,175,22,2481,3016,3015,2482
2021-01-05,43,0,9,6,25,3,0,16,27,15,28,5539,34,2592,985,1728,178,22,2497,3042,3030,2509
2021-01-06,31,0,9,1,21,0,0,6,25,15,16,5569,34,2601,985,1749,178,22,2502,3067,3045,2524
2021-01-07,37,0,17,3,14,3,0,14,23,26,11,5606,34,2618,988,1763,181,22,2516,3090,3071,2535
2021-01-08,41,0,9,3,27,2,0,6,35,10,31,5647,34,2627,991,1790,183,22,2522,3125,3081,2566
2021-01-09,45,0,11,1,29,4,0,10,35,25,20,5692,34,2638,992,1819,187,22,2532,3160,3106,2586
2021-01-10,34,0,19,5,7,3,0,14,20,23,11,5727,34,2658,997,1826,190,22,2546,3181,3129,2598
2021-01-11,32,0,10,5,13,4,0,11,21,17,15,5759,34,2668,1002,1839,194,22,2557,3202,3146,2613
2021-01-12,29,0,4,4,20,1,0,8,21,8,21,5788,34,2672,1006,1859,195,22,2565,3223,3154,2634
2021-01-13,26,0,10,2,14,0,0,3,23,16,10,5814,34,2682,1008,1873,195,22,2568,3246,3170,2644
2021-01-14,28,0,12,1,8,7,0,11,17,19,9,5842,34,2694,1009,1881,202,22,2579,3263,3189,2653
2021-01-15,29,0,7,0,16,6,0,5,24,22,7,5869,34,2701,1009,1895,208,22,2584,3285,3211,2658
2021-01-16,33,0,19,5,5,4,0,8,25,13,20,5902,34,2720,1014,1900,212,22,2592,3310,3224,2678
2021-01-17,20,0,8,5,7,0,0,8,12,12,8,5922,34,2728,1019,1907,212,22,2600,3322,3236,2686
2021-01-18,23,0,12,2,8,1,0,10,13,11,12,5945,34,2740,1021,1915,213,22,2610,3335,3247,2698
2021-01-19,35,0,12,3,17,3,0,8,27,18,17,5980,34,2752,1024,1932,216,22,2618,3362,3265,2715
2021-01-20,31,0,8,6,11,6,0,1,30,13,18,6011,34,2760,1030,1943,222,22,2619,3392,3278,2733
2021-01-21,21,0,3,7,8,3,0,6,15,10,11,6031,34,2762,1037,1951,225,22,2624,3407,3287,2744
2021-01-22,32,0,7,2,18,5,0,9,23,22,10,6062,34,2769,1039,1968,230,22,2633,3429,3309,2753
2021-01-23,28,0,10,6,10,2,0,12,16,16,12,6089,34,2779,1044,1978,232,22,2644,3445,3325,2764
2021-01-24,23,0,11,7,3,2,0,9,14,12,11,6112,34,2790,1051,1981,234,22,2653,3459,3337,2775
2021-01-25,32,1,11,8,8,4,0,11,21,19,13,6144,35,2801,1059,1989,238,22,2664,3480,3356,2788
2021-01-26,16,0,5,4,5,1,1,6,10,9,7,6160,35,2806,1063,1994,239,23,2670,3490,3365,2795
2021-01-27,43,0,7,7,28,1,0,12,31,22,21,6203,35,2813,1070,2022,240,23,2682,3521,3387,2816
2021-01-28,18,0,3,5,8,2,0,7,11,14,4,6221,35,2816,1075,2030,242,23,2689,3532,3401,2820
2021-01-29,24,0,7,3,13,1,0,9,15,15,9,6245,35,2823,1078,2043,243,23,2698,3547,3416,2829
2021-01-30,35,0,17,2,14,2,0,15,20,16,19,6278,35,2839,1080,2056,245,23,2711,3567,3431,2847
2021-01-31,30,0,12,3,13,2,0,15,15,24,6,6308,35,2851,1083,2069,247,23,2726,3582,3455,2853
2021-02-01,20,0,8,4,5,3,0,6,14,13,7,6328,35,2859,1087,2074,250,23,2732,3596,3468,2860
2021-02-02,41,0,17,7,14,3,0,12,29,23,18,6369,35,2876,1094,2088,253,23,2744,3625,3491,2878
2021-02-03,34,3,8,15,5,3,0,17,17,21,13,6403,38,2884,1109,2093,256,23,2761,3642,3512,2891
2021-02-04,22,0,6,3,12,1,0,6,16,10,12,6425,38,2890,1112,2105,257,23,2767,3658,3522,2903
2021-02-05,19,0,8,3,5,3,0,7,12,8,11,6444,38,2898,1115,2110,260,23,2774,3670,3530,2914
2021-02-06,27,0,11,3,12,1,0,11,16,10,17,6472,38,2910,1118,2122,261,23,2785,3687,3541,2931
2021-02-07,46,1,19,3,13,10,0,27,19,25,21,6519,39,2930,1121,2135,271,23,2812,3707,3567,2952
2021-02-08,25,1,9,6,3,6,0,9,16,12,13,6544,40,2939,1127,2138,277,23,2821,3723,3579,2965
2021-02-09,30,0,8,9,11,2,0,11,19,13,17,6574,40,2946,1136,2149,280,23,2832,3742,3592,2982
2021-02-10,30,0,9,9,9,3,0,6,24,16,14,6603,39,2955,1145,2158,283,23,2837,3766,3609,2994
2021-02-11,37,0,15,7,14,1,0,15,22,20,17,6640,39,2970,1152,2172,284,23,2852,3788,3629,3011
2021-02-12,19,0,9,1,7,2,0,6,13,13,6,6659,39,2979,1153,2179,286,23,2858,3801,3642,3017
2021-02-13,17,0,9,0,6,2,0,5,12,6,11,6676,39,2988,1153,2185,288,23,2863,3813,3648,3028
2021-02-14,22,0,6,5,8,3,0,7,15,13,9,6698,39,2994,1158,2193,291,23,2870,3828,3661,3037
2021-02-15,21,0,7,6,5,3,0,6,15,9,12,6719,39,3001,1164,2198,294,23,2876,3843,3670,3049
2021-02-16,28,0,13,9,6,0,0,8,20,11,17,6747,39,3014,1173,2204,294,23,2884,3863,3681,3066
2021-02-17,31,1,7,9,8,6,0,6,25,6,25,6778,40,3021,1182,2212,300,23,2890,3888,3687,3091
2021-02-18,31,0,10,6,14,1,0,12,19,19,12,6809,40,3031,1188,2226,301,23,2902,3907,3706,3103
2021-02-19,28,0,15,4,7,2,0,10,18,17,11,6837,40,3046,1192,2233,303,23,2912,3925,3723,3114
2021-02-20,32,0,14,6,6,6,0,7,25,10,22,6869,40,3060,1198,2239,309,23,2919,3950,3733,3136
2021-02-21,25,0,12,5,4,4,0,8,17,14,11,6894,40,3072,1203,2243,313,23,2927,3967,3747,3147
2021-02-22,19,0,8,2,7,2,0,4,15,7,12,6913,40,3080,1205,2250,315,23,2931,3982,3754,3159
2021-02-23,27,0,11,6,8,2,0,5,22,10,17,6940,40,3091,1211,2258,317,23,2936,4004,3764,3176
2021-02-24,23,0,11,1,9,2,0,4,19,10,13,6963,40,3102,1212,2267,319,23,2940,4023,3774,3189
2021-02-25,27,0,11,5,8,3,0,10,17,20,7,6990,40,3113,1217,2275,322,23,2950,4040,3794,3196
2021-02-26,24,0,11,4,5,4,0,8,16,10,14,7014,40,3124,1221,2280,326,23,2958,4056,3806,3208
2021-02-27,10,0,6,0,3,1,0,3,7,1,9,7024,40,3130,1221,2283,327,23,2961,4063,3807,3217
2021-02-28,22,0,7,6,4,5,0,9,13,3,19,7046,40,3137,1227,2287,332,23,2970,4076,3810,3236
2021-03-01,17,0,11,1,3,2,0,5,12,9,8,7063,40,3148,1228,2290,334,23,2975,4088,3819,3244
2021-03-02,25,0,9,3,9,4,0,9,16,12,13,7088,40,3157,1231,2299,338,23,2984,4104,3831,3257
2021-03-03,18,0,8,4,6,0,0,2,16,9,9,7106,40,3165,1235,2305,338,23,2986,4120,3840,3266
2021-03-04,23,0,10,3,8,2,0,6,17,9,14,7129,40,3175,1238,2313,340,23,2992,4137,3849,3280
2021-03-05,17,0,7,0,7,3,0,4,13,8,9,7146,40,3182,1238,2320,343,23,2996,4150,3857,3289
2021-03-06,14,0,8,0,4,2,0,6,8,7,7,7160,40,3190,1238,2324,345,23,3002,4158,3864,3296
2021-03-07,17,0,9,2,5,1,0,5,12,6,11,7177,40,3199,1240,2329,346,23,3008,4169,3871,3306
2021-03-08,11,0,7,1,1,2,0,5,6,5,6,7188,40,3206,1241,2330,348,23,3012,4176,3875,3313
2021-03-09,19,0,7,0,10,2,0,4,15,11,8,7207,40,3213,1241,2340,350,23,3016,4191,3886,3321
2021-03-10,18,0,8,1,8,1,0,5,13,9,9,7225,40,3221,1242,2348,351,23,3021,4204,3895,3330
2021-03-11,21,0,8,5,6,2,0,10,11,11,10,7246,40,3229,1247,2354,353,23,3031,4215,3906,3340
2021-03-12,21,0,10,2,6,3,0,6,15,9,12,7267,40,3239,1249,2360,356,23,3037,4230,3915,3352
2021-03-13,16,1,7,2,5,1,0,6,10,6,10,7283,41,3246,1251,2365,357,23,3043,4240,3921,3362
2021-03-14,23,0,12,5,6,0,0,6,17,11,12,7306,41,3258,1256,2371,357,23,3049,4257,3932,3374
2021-03-15,12,0,7,1,4,0,0,7,5,7,5,7318,41,3265,1257,2375,357,23,3056,4262,3939,3379
2021-03-16,18,0,12,1,4,1,0,7,11,10,8,7336,41,3277,1258,2379,358,23,3063,4273,3949,3387
2021-03-17,17,0,9,6,2,0,0,9,8,9,8,7353,41,3286,1264,2381,358,23,3072,4281,3958,3395
2021-03-18,18,0,7,6,5,0,0,9,9,8,10,7371,41,3293,1270,2386,358,23,3081,4290,3966,3405
2021-03-19,22,0,8,5,7,2,0,7,15,7,15,7393,41,3301,1275,2393,360,23,3088,4305,3973,3420
2021-03-20,12,1,7,3,1,0,0,4,8,4,8,7405,42,3308,1278,2394,360,23,3092,4313,3977,3428
2021-03-21,19,0,11,3,1,4,0,9,10,10,9,7424,42,3319,1281,2395,364,23,3101,4323,3987,3437
2021-03-22,19,0,8,6,4,1,0,7,12,10,9,7443,42,3327,1287,2399,365,23,3108,4335,3997,3446
2021-03-23,15,0,3,5,5,2,0,8,7,10,5,7458,42,3330,1292,2404,367,23,3116,4342,4007,3451
2021-03-24,17,0,7,2,6,2,0,8,9,4,13,7476,42,3337,1294,2411,369,23,3124,4352,4012,3464
2021-03-25,11,0,5,1,5,0,0,5,6,4,7,7487,42,3342,1295,2416,369,23,3129,4358,4016,3471
2021-03-26,23,0,13,2,8,0,0,3,20,8,15,7510,42,3355,1297,2424,369,23,3132,4378,4024,3486
2021-03-27,15,0,13,0,0,2,0,3,12,4,11,7525,42,3368,1297,2424,371,23,3135,4390,4028,3497
2021-03-28,20,0,15,1,0,4,0,9,11,8,12,7545,42,3383,1298,2424,375,23,3144,4401,4036,3509
2021-03-29,14,0,7,3,2,2,0,5,9,9,5,7559,42,3390,1301,2426,377,23,3149,4410,4045,3514
2021-03-30,18,0,5,9,4,0,0,3,15,13,5,7576,42,3394,1310,2430,377,23,3151,4425,4058,3518
2021-03-31,15,0,7,3,4,1,0,7,8,10,5,7588,42,3400,1312,2433,378,23,3158,4430,4065,3523
2021-04-01,14,0,5,7,2,0,0,2,12,10,4,7602,42,3405,1319,2435,378,23,3160,4442,4075,3527
2021-04-02,25,0,13,5,5,2,0,11,14,9,16,7628,42,3418,1324,2441,380,23,3171,4457,4084,3544
2021-04-03,22,0,12,5,4,1,0,9,13,11,11,7650,42,3430,1329,2445,381,23,3180,4470,4095,3555
2021-04-04,29,0,19,1,4,5,0,10,19,13,16,7679,42,3449,1330,2449,386,23,3190,4489,4108,3571
2021-04-05,24,0,10,3,9,2,0,10,14,12,12,7703,42,3459,1333,2458,388,23,3200,4503,4120,3583
2021-04-06,18,1,6,4,6,1,0,5,13,3,15,7721,43,3465,1337,2464,389,23,3205,4516,4123,3598
2021-04-07,15,0,7,7,1,0,0,4,11,10,5,7736,43,3472,1344,2465,389,23,3209,4527,4133,3603
2021-04-08,26,1,14,9,2,0,0,7,19,15,11,7762,44,3486,1353,2467,389,23,3216,4546,4148,3614
2021-04-09,27,0,19,2,4,1,1,7,20,12,15,7789,44,3505,1355,2471,390,24,3223,4566,4160,3629
2021-04-10,15,0,10,1,4,0,0,4,11,10,5,7804,44,3515,1356,2475,390,24,3227,4577,4170,3634
2021-04-11,20,0,13,2,2,3,0,8,12,13,7,7824,44,3528,1358,2477,393,24,3235,4589,4183,3641
2021-04-12,27,0,14,11,0,2,0,8,19,14,13,7851,44,3542,1369,2477,395,24,3243,4608,4197,3654
2021-04-13,14,0,7,3,3,1,0,5,9,7,7,7865,44,3549,1372,2480,396,24,3248,4617,4204,3661
2021-04-14,17,0,13,1,2,1,0,12,5,4,13,7882,44,3562,1373,2482,397,24,3260,4622,4208,3674
2021-04-15,28,0,19,4,3,2,0,15,13,8,20,7910,44,3581,1377,2485,399,24,3275,4635,4216,3694
2021-04-16,21,0,11,4,3,3,0,11,10,7,14,7931,44,3592,1381,2488,402,24,3286,4645,4223,3708
2021-04-17,28,0,22,4,1,1,0,7,21,11,17,7959,44,3615,1385,2489,402,24,3293,4666,4235,3724
2021-04-18,23,1,15,2,3,2,0,9,14,10,13,7982,45,3630,1387,2492,404,24,3302,4680,4245,3737
2021-04-19,20,0,11,7,2,0,0,8,12,13,7,8002,45,3641,1394,2494,404,24,3310,4692,4258,3744
2021-04-20,20,0,17,1,2,0,0,10,10,11,9,8022,45,3658,1395,2496,404,24,3320,4702,4269,3753
2021-04-21,39,0,31,2,6,0,0,13,26,18,21,8061,45,3689,1397,2502,404,24,3333,4728,4287,3774
2021-04-22,20,0,10,5,2,3,0,5,15,14,6,8081,45,3699,1402,2504,407,24,3338,4743,4301,3780
2021-04-23,39,0,22,9,7,1,0,23,16,14,25,8120,45,3721,1411,2511,408,24,3361,4759,4315,3805
2021-04-24,25,0,14,7,1,3,0,11,14,13,12,8145,45,3735,1418,2512,411,24,3372,4773,4328,3817
2021-04-25,41,1,32,2,4,2,0,30,11,24,17,8186,46,3767,1420,2516,413,24,3402,4784,4352,3834
2021-04-26,31,0,23,3,4,1,0,21,10,17,14,8217,46,3790,1423,2520,414,24,3423,4794,4369,3848
2021-04-27,35,8,22,1,4,0,0,23,12,12,23,8251,54,3811,1424,2524,414,24,3445,4806,4381,3870
2021-04-28,21,0,15,5,1,0,0,7,14,12,9,8272,54,3826,1429,2525,414,24,3452,4820,4393,3879
2021-04-29,30,0,23,4,3,0,0,11,19,14,16,8302,54,3849,1433,2528,414,24,3463,4839,4407,3895
2021-04-30,19,0,17,0,2,0,0,5,14,9,10,8322,54,3867,1433,2530,414,24,3468,4854,4417,3905
2021-05-01,34,0,19,6,4,3,2,15,19,13,21,8356,54,3886,1439,2534,417,26,3483,4873,4430,3926
2021-05-02,21,0,17,3,1,0,0,6,15,11,10,8377,54,3903,1442,2535,417,26,3489,4888,4441,3936
2021-05-03,23,0,16,4,3,0,0,11,12,13,10,8400,54,3919,1446,2538,417,26,3500,4900,4454,3946
2021-05-04,27,0,16,4,7,0,0,7,20,11,16,8427,54,3935,1450,2545,417,26,3507,4920,4465,3962
2021-05-05,25,1,18,5,1,0,0,12,13,9,16,8452,55,3953,1455,2546,417,26,3519,4933,4474,3978
2021-05-06,12,0,8,2,0,2,0,8,4,4,8,8464,55,3961,1457,2546,419,26,3527,4937,4478,3986
2021-05-07,16,0,10,2,3,1,0,4,12,8,8,8480,55,3971,1459,2549,420,26,3531,4949,4486,3994
2021-05-08,29,0,23,2,4,0,0,17,12,14,15,8511,55,3996,1461,2553,420,26,3548,4963,4502,4009
2021-05-09,42,1,35,2,1,3,0,31,11,13,29,8553,56,4031,1463,2554,423,26,3579,4974,4515,4038
2021-05-10,27,1,23,2,1,0,0,13,14,7,20,8580,57,4054,1465,2555,423,26,3592,4988,4522,4058
2021-05-11,28,0,19,0,8,1,0,12,16,11,17,8608,57,4073,1465,2563,424,26,3604,5004,4533,4075
2021-05-12,22,0,15,3,4,0,0,13,9,11,11,8630,57,4088,1468,2567,424,26,3617,5013,4545,4085
2021-05-13,23,0,12,8,3,0,0,14,9,17,6,8653,57,4100,1476,2570,424,26,3631,5022,4562,4091
2021-05-14,18,0,16,0,2,0,0,9,9,10,8,8671,57,4116,1476,2572,424,26,3640,5031,4572,4099
2021-05-15,20,0,11,5,3,1,0,9,11,9,11,8691,57,4127,1481,2575,425,26,3649,5042,4581,4110
2021-05-16,38,0,29,2,7,0,0,20,18,20,18,8729,57,4157,1482,2582,425,26,3669,5060,4601,4128
2021-05-17,22,0,13,4,5,0,0,9,13,15,7,8751,57,4170,1486,2587,425,26,3678,5073,4616,4135
2021-05-18,22,0,16,1,4,1,0,12,10,11,11,8773,57,4186,1487,2591,426,26,3690,5083,4628,4145
2021-05-19,17,1,12,0,1,3,0,7,10,7,10,8789,58,4198,1487,2591,429,26,3697,5092,4634,4155
2021-05-20,27,0,19,2,4,2,0,16,11,13,14,8816,58,4217,1489,2595,431,26,3713,5103,4647,4169
2021-05-21,19,0,11,3,1,4,0,10,9,11,8,8835,58,4228,1492,2596,435,26,3723,5112,4658,4177
2021-05-22,33,10,19,0,1,3,0,21,12,16,17,8868,68,4247,1492,2597,438,26,3744,5124,4674,4194
2021-05-23,15,0,7,1,3,3,1,10,5,8,7,8883,68,4254,1493,2600,441,27,3754,5129,4682,4201
2021-05-24,25,1,18,3,3,0,0,11,14,14,11,8908,69,4272,1496,2603,441,27,3765,5143,4696,4212
2021-05-25,35,5,21,3,6,0,0,22,13,10,25,8943,74,4293,1499,2609,441,27,3787,5156,4706,4237
2021-05-26,23,0,16,2,3,2,0,13,10,13,10,8966,74,4309,1501,2612,443,27,3800,5166,4719,4247
2021-05-27,9,0,6,1,2,0,0,3,6,4,5,8975,74,4315,1502,2614,443,27,3803,5172,4723,4252
2021-05-28,16,0,11,0,4,1,0,11,5,4,12,8991,74,4326,1502,2618,444,27,3814,5177,4727,4264
2021-05-29,28,0,21,2,2,3,0,16,12,23,5,9019,74,4347,1504,2620,447,27,3830,5189,4750,4269
2021-05-30,16,0,9,3,3,1,0,7,9,13,3,9034,74,4355,1507,2623,448,27,3837,5197,4762,4272
2021-05-31,19,0,13,1,3,2,0,7,12,11,8,9053,74,4368,1508,2626,450,27,3844,5209,4773,4280
2021-06-01,10,2,3,0,5,0,0,4,6,7,3,9063,76,4371,1508,2631,450,27,3848,5215,4780,4283
2021-06-02,23,0,13,2,8,0,0,9,14,6,17,9086,76,4384,1510,2639,450,27,3857,5229,4786,4300
2021-06-03,9,0,2,0,7,0,0,3,6,2,7,9095,76,4386,1510,2646,450,27,3860,5235,4788,4307
2021-06-04,21,1,15,2,3,0,0,8,13,11,10,9116,77,4401,1512,2649,450,27,3868,5248,4799,4317
2021-06-05,19,1,11,0,5,2,0,5,14,11,8,9135,78,4412,1512,2654,452,27,3873,5262,4810,4325
2021-06-06,15,0,10,3,1,1,0,5,10,12,3,9150,78,4422,1515,2655,453,27,3878,5272,4822,4328
2021-06-07,31,0,26,2,3,0,0,10,21,11,20,9181,78,4448,1517,2658,453,27,3888,5293,4833,4348
2021-06-08,19,0,12,1,6,0,0,8,11,8,11,9200,78,4460,1518,2664,453,27,3896,5304,4841,4359
2021-06-09,21,0,14,3,4,0,0,5,16,10,11,9220,78,4473,1521,2668,453,27,3901,5319,4852,4368
2021-06-10,17,0,11,0,3,3,0,8,9,8,9,9237,78,4484,1521,2671,456,27,3909,5328,4858,4379
2021-06-11,15,0,12,0,3,0,0,4,11,4,11,9252,78,4496,1521,2674,456,27,3913,5339,4862,4390
2021-06-12,40,0,34,1,2,3,0,9,31,15,25,9292,78,4530,1522,2676,459,27,3922,5370,4877,4415
2021-06-13,33,0,23,2,6,2,0,17,16,15,18,9325,78,4553,1524,2682,461,27,3939,5386,4892,4433
2021-06-14,39,0,32,1,4,2,0,16,23,20,19,9364,78,4585,1525,2686,463,27,3955,5409,4912,4452
2021-06-15,27,0,21,2,2,2,0,9,18,14,13,9391,78,4606,1527,2688,465,27,3964,5427,4926,4465
2021-06-16,23,0,19,1,3,0,0,8,15,6,17,9413,78,4624,1528,2691,465,27,3972,5441,4932,4481
2021-06-17,17,0,13,2,2,0,0,8,9,9,8,9430,78,4637,1530,2693,465,27,3980,5450,4941,4489
2021-06-18,23,0,21,1,0,1,0,10,13,14,9,9453,78,4658,1531,2693,466,27,3990,5463,4955,4498
2021-06-19,26,1,17,1,5,2,0,12,14,8,18,9479,79,4675,1532,2698,468,27,4002,5477,4963,4516
2021-06-20,49,0,38,1,8,2,0,19,30,31,18,9528,79,4713,1533,2706,470,27,4021,5507,4994,4534
2021-06-21,40,0,33,1,2,4,0,12,28,27,13,9568,79,4746,1534,2708,474,27,4033,5535,5021,4547
2021-06-22,44,0,39,2,2,1,0,29,15,31,13,9611,79,4784,1536,2710,475,27,4062,5549,5051,4560
2021-06-23,40,0,29,4,5,2,0,13,27,18,22,9651,79,4813,1540,2715,477,27,4075,5576,5069,4582
2021-06-24,34,0,30,1,3,0,0,19,15,14,20,9685,79,4843,1541,2718,477,27,4094,5591,5083,4602
2021-06-25,32,0,27,3,1,1,0,13,19,21,11,9717,79,4870,1544,2719,478,27,4107,5610,5104,4613
2021-06-26,57,0,54,1,1,1,0,31,26,27,30,9774,79,4924,1545,2720,479,27,4138,5636,5131,4643
2021-06-27,44,0,39,1,1,3,0,34,10,30,14,9818,79,4963,1546,2721,482,27,4172,5646,5161,4657
2021-06-28,29,0,22,2,4,1,0,11,18,25,4,9847,79,4985,1548,2725,483,27,4183,5664,5186,4661
2021-06-29,35,0,29,3,3,0,0,16,19,24,11,9882,80,5013,1551,2728,483,27,4198,5684,5210,4672
2021-06-30,35,0,27,6,1,1,0,17,18,18,17,9917,79,5041,1557,2729,484,27,4216,5701,5228,4689
2021-07-01,50,0,49,0,1,0,0,31,19,32,18,9967,79,5090,1557,2730,484,27,4247,5720,5260,4707
2021-07-02,61,1,51,1,1,7,0,33,28,37,24,10028,80,5141,1558,2731,491,27,4280,5748,5297,4731
2021-07-03,46,0,38,2,4,2,0,23,23,19,27,10074,80,5179,1560,2735,493,27,4303,5771,5316,4758
2021-07-04,81,0,75,1,3,2,0,50,31,47,34,10154,80,5254,1561,2737,495,27,4353,5801,5363,4791
2021-07-05,67,0,60,3,3,1,0,25,42,40,27,10221,80,5314,1564,2740,496,27,4378,5843,5403,4818
2021-07-06,56,1,44,8,0,3,0,30,26,43,13,10277,81,5358,1572,2740,499,27,4408,5869,5446,4831
2021-07-07,44,0,35,4,3,2,0,20,24,24,20,10321,81,5393,1576,2743,501,27,4428,5893,5470,4851
2021-07-08,48,0,43,3,1,1,0,25,23,25,23,10369,81,5436,1579,2744,502,27,4453,5916,5495,4874
2021-07-09,80,0,71,6,3,0,0,39,41,30,50,10449,81,5507,1585,2747,502,27,4492,5957,5525,4924
2021-07-10,58,1,48,2,2,5,0,21,37,27,31,10507,82,5555,1587,2749,507,27,4513,5994,5552,4955
2021-07-11,44,1,40,1,2,0,0,12,32,20,24,10551,83,5595,1588,2751,507,27,4525,6026,5572,4979
2021-07-12,37,0,33,2,2,0,0,20,17,13,24,10588,83,5628,1590,2753,507,27,4545,6043,5585,5003
2021-07-13,53,0,41,5,3,3,1,29,24,23,30,10641,83,5669,1595,2756,510,28,4574,6067,5608,5033
2021-07-14,47,0,37,6,4,0,0,19,28,28,19,10688,83,5698,1601,2758,510,28,4593,6095,5636,5052
2021-07-15,45,0,39,2,3,1,0,28,17,14,31,10733,83,5745,1603,2763,511,28,4621,6112,5650,5083
2021-07-16,60,0,49,4,4,3,0,34,26,28,32,10793,83,5794,1607,2767,514,28,4655,6138,5678,5115
2021-07-17,51,1,44,1,1,4,0,24,27,20,31,10844,84,5838,1607,2768,519,28,4679,6165,5698,5146
2021-07-18,52,0,48,1,1,2,0,16,36,21,31,10896,84,5886,1608,2769,521,28,4695,6201,5719,5177
2021-07-19,44,0,32,10,2,0,0,14,30,23,21,10940,84,5918,1618,2771,521,28,4709,6231,5742,5198
2021-07-20,36,0,25,4,4,3,0,7,29,18,18,10976,84,5943,1622,2775,524,28,4716,6260,5760,5216
2021-07-21,58,0,46,3,6,3,0,23,35,29,29,11034,84,5989,1625,2781,527,28,4739,6295,5789,5245
2021-07-22,309,0,34,2,3,270,0,290,19,284,25,11341,84,6021,1627,2784,797,28,5027,6314,6073,5268
2021-07-23,56,0,43,5,4,2,2,20,36,20,36,11397,84,6064,1632,2788,799,30,5047,6350,6093,5304
2021-07-24,56,0,47,2,6,1,0,19,37,21,35,11453,84,6111,1634,2794,800,30,5066,6387,6114,5339
2021-07-25,65,0,50,8,2,5,0,31,34,41,24,11517,84,6160,1642,2796,805,30,5097,6420,6154,5363
2021-07-26,54,0,42,8,1,3,0,21,33,29,25,11571,84,6202,1650,2797,808,30,5118,6453,6183,5388
2021-07-27,89,0,66,13,7,3,0,45,44,40,49,11660,84,6268,1663,2804,811,30,5163,6497,6223,5437
2021-07-28,73,0,63,5,3,2,0,33,40,28,45,11733,84,6331,1668,2807,813,30,5196,6537,6251,5482
2021-07-29,42,0,31,5,2,4,0,18,24,26,16,11775,84,6362,1672,2809,818,30,5214,6561,6277,5498
2021-07-30,48,1,39,6,2,0,0,17,31,17,31,11823,85,6401,1678,2811,818,30,5231,6592,6294,5529
2021-07-31,73,0,53,9,10,1,0,25,48,30,43,11896,85,6454,1687,2821,819,30,5257,6639,6324,5572
2021-08-01,56,0,35,13,6,2,0,19,37,33,23,11952,85,6489,1700,2827,821,30,5276,6676,6357,5595
2021-08-02,69,0,45,17,6,1,0,25,44,34,35,12020,85,6533,1717,2833,822,30,5301,6719,6391,5629
2021-08-03,50,0,31,7,8,4,0,11,39,23,27,12069,85,6563,1724,2841,826,30,5312,6757,6414,5655
2021-08-04,61,6,46,6,3,0,0,30,31,18,43,12130,91,6609,1730,2844,826,30,5342,6788,6432,5698
2021-08-05,59,0,35,11,6,7,0,33,26,39,20,12189,91,6644,1741,2850,833,30,5375,6814,6471,5718
2021-08-06,64,0,45,10,9,0,0,28,36,28,36,12254,91,6687,1754,2859,833,30,5403,6851,6500,5754
2021-08-07,61,1,42,4,11,3,0,25,36,28,33,12315,92,6729,1758,2870,836,30,5428,6887,6529,5786
2021-08-08,59,0,46,6,6,1,0,16,43,24,35,12374,92,6777,1761,2877,837,30,5444,6930,6553,5821
2021-08-09,37,0,25,6,5,1,0,13,24,16,21,12411,92,6802,1767,2882,838,30,5457,6954,6569,5842
2021-08-10,64,0,40,8,14,2,0,13,51,35,29,12475,92,6842,1775,2896,840,30,5470,7005,6604,5871
2021-08-11,78,12,50,8,7,1,0,27,51,36,42,12552,104,6891,1783,2903,841,30,5497,7055,6639,5913
2021-08-12,40,0,25,7,3,5,0,16,24,21,19,12592,104,6916,1790,2906,846,30,5513,7079,6660,5932
2021-08-13,77,3,42,7,14,11,0,18,59,28,49,12669,107,6958,1797,2920,857,30,5531,7138,6688,5981
2021-08-14,70,8,50,4,6,2,0,24,46,18,52,12738,115,7006,1801,2926,860,30,5555,7183,6705,6033
2021-08-15,68,1,48,4,7,8,0,24,44,29,39,12806,116,7054,1805,2933,868,30,5579,7227,6734,6072
2021-08-16,63,1,24,13,3,22,0,31,32,40,23,12869,117,7078,1818,2936,890,30,5611,7258,6774,6095
2021-08-17,50,0,20,19,8,3,0,14,36,31,19,12919,117,7098,1837,2944,893,30,5625,7294,6805,6114
2021-08-18,38,0,26,6,3,3,0,15,23,13,25,12957,117,7124,1843,2947,896,30,5640,7317,6818,6139
2021-08-19,38,0,21,4,10,3,0,13,25,15,23,12995,117,7145,1847,2957,899,30,5653,7342,6833,6162
2021-08-20,51,0,34,4,9,4,0,13,38,24,27,13045,116,7179,1851,2966,903,30,5666,7379,6856,6189
2021-08-21,66,0,49,8,6,3,0,20,46,25,41,13111,116,7228,1859,2972,906,30,5686,7425,6881,6230
2021-08-22,38,0,26,7,1,4,0,9,29,14,24,13149,116,7254,1866,2973,910,30,5695,7454,6895,6254
2021-08-23,48,0,25,3,10,10,0,20,28,25,23,13196,116,7278,1869,2983,920,30,5714,7482,6921,6275
2021-08-24,39,0,17,6,12,4,0,12,27,20,19,13232,116,7294,1873,2995,924,30,5726,7506,6939,6293
2021-08-25,41,0,22,9,7,3,0,12,29,16,25,13272,116,7316,1881,3002,927,30,5738,7534,6954,6318
2021-08-26,53,0,39,3,6,5,0,23,30,17,36,13325,116,7355,1884,3008,932,30,5761,7564,6971,6354
2021-08-27,30,0,21,5,3,1,0,10,20,12,18,13355,116,7376,1889,3011,933,30,5771,7584,6983,6372
2021-08-28,55,0,41,8,4,2,0,11,44,17,38,13410,116,7417,1897,3015,935,30,5782,7628,7000,6410
2021-08-29,43,0,22,6,8,7,0,12,31,16,27,13451,116,7438,1903,3022,942,30,5794,7657,7015,6436
2021-08-30,61,1,48,5,4,3,0,29,32,17,44,13512,117,7486,1908,3026,945,30,5823,7689,7032,6480
2021-08-31,39,1,22,3,11,2,0,13,26,18,21,13550,118,7508,1911,3037,946,30,5836,7714,7050,6500
2021-09-01,33,0,21,1,9,2,0,5,28,13,20,13583,118,7529,1912,3046,948,30,5841,7742,7063,6520
2021-09-02,34,0,23,3,7,1,0,5,29,12,22,13615,118,7550,1915,3053,949,30,5846,7769,7075,6540
2021-09-03,34,0,23,3,6,2,0,11,23,8,26,13649,118,7573,1918,3059,951,30,5857,7792,7083,6566
2021-09-04,28,0,20,2,4,2,0,6,22,11,17,13677,118,7593,1920,3063,953,30,5863,7814,7094,6583
2021-09-05,29,0,18,4,6,1,0,9,20,11,18,13706,118,7611,1924,3069,954,30,5872,7834,7105,6601
2021-09-06,24,0,15,3,4,2,0,6,18,16,8,13730,118,7626,1927,3073,956,30,5878,7852,7121,6609
2021-09-07,34,0,22,1,10,1,0,9,25,15,19,13764,118,7648,1928,3083,957,30,5887,7877,7136,6628
2021-09-08,36,1,25,4,4,1,1,9,27,9,27,13800,119,7673,1932,3087,958,31,5896,7904,7145,6655
2021-09-09,31,0,16,6,7,2,0,11,20,13,18,13831,119,7689,1938,3094,960,31,5907,7924,7158,6673
2021-09-10,35,0,25,3,3,4,0,8,27,17,18,13866,119,7714,1941,3097,964,31,5915,7951,7176,6690
2021-09-11,49,1,42,1,2,3,0,19,30,7,42,13915,120,7756,1942,3099,967,31,5934,7981,7183,6732
2021-09-12,30,1,26,0,0,3,0,8,22,6,24,13945,121,7782,1942,3099,970,31,5942,8003,7189,6756
2021-09-13,24,0,16,2,5,1,0,10,14,9,15,13969,121,7798,1944,3104,971,31,5952,8017,7198,6771
2021-09-14,34,6,15,3,5,5,0,6,28,12,22,14003,127,7813,1947,3109,976,31,5958,8045,7210,6793
2021-09-15,23,1,15,2,5,0,0,5,18,7,16,14027,128,7829,1949,3114,976,31,5963,8064,7217,6810
2021-09-16,22,1,15,2,2,2,0,7,15,8,14,14049,129,7844,1951,3116,978,31,5970,8079,7225,6824
2021-09-17,35,0,24,2,4,5,0,16,19,7,28,14084,129,7868,1953,3120,983,31,5986,8098,7232,6852
2021-09-18,40,1,31,5,2,1,0,11,29,11,29,14123,130,7898,1958,3122,984,31,5997,8126,7243,6880
2021-09-19,39,0,31,5,1,2,0,7,32,9,30,14162,130,7929,1963,3123,986,31,6004,8158,7252,6910
2021-09-20,28,0,17,1,6,3,1,7,21,13,15,14190,130,7946,1964,3129,989,32,6011,8179,7265,6925
2021-09-21,32,3,25,1,0,3,0,14,18,9,23,14222,133,7971,1965,3129,992,32,6025,8197,7274,6948
2021-09-22,17,1,13,0,2,1,0,6,11,2,15,14239,134,7984,1965,3131,993,32,6031,8208,7276,6963
2021-09-23,18,0,14,2,2,0,0,3,15,5,13,14257,134,7998,1967,3133,993,32,6034,8223,7281,6976
2021-09-24,18,0,11,0,4,2,1,7,11,3,15,14275,134,8009,1967,3137,995,33,6041,8234,7284,6991
2021-09-25,28,1,20,4,1,1,1,8,20,7,21,14303,135,8029,1971,3138,996,34,6049,8254,7291,7012
2021-09-26,36,0,31,0,3,2,0,10,26,7,29,14339,135,8060,1971,3141,998,34,6059,8280,7298,7041
2021-09-27,27,2,20,3,2,0,0,12,15,8,19,14366,137,8080,1974,3143,998,34,6071,8295,7306,7060
2021-09-28,19,0,11,2,6,0,0,3,16,9,10,14385,137,8091,1976,3149,998,34,6074,8311,7315,7070
2021-09-29,26,1,16,5,2,2,0,9,17,6,20,14410,138,8107,1981,3151,999,34,6082,8328,7320,7090
2021-09-30,25,2,22,0,1,0,0,9,16,4,21,14435,140,8129,1981,3152,999,34,6091,8344,7324,7111
2021-10-01,35,2,19,2,10,2,0,7,28,17,18,14470,142,8148,1983,3162,1001,34,6098,8372,7341,7129
2021-10-02,27,1,15,5,4,1,1,7,20,13,14,14497,143,8163,1988,3166,1002,35,6105,8392,7354,7143
2021-10-03,28,0,13,3,9,3,0,6,22,12,16,14525,143,8176,1991,3175,1005,35,6111,8414,7366,7159
2021-10-04,20,0,9,3,8,0,0,9,11,7,13,14545,143,8185,1994,3183,1005,35,6120,8425,7373,7172
2021-10-05,18,0,16,0,2,0,0,8,10,5,13,14563,143,8201,1994,3185,1005,35,6128,8435,7379,7184
2021-10-06,26,2,15,2,6,1,0,11,15,7,19,14590,145,8216,1996,3192,1006,35,6139,8451,7387,7203
